XXXXXXXXXXXXXX
X    XXX     X
X XX     XX  X
X XX  X  XXX X
X XXX XX  X  X
X  X   X     X
X  X   X   XXX
X X  XXXXX   X
X       X  X X
X   X        X
XXXXXXXXXXXXXX
